аврора==Снимай трусы без разговора
арбуз==Твой папа карапуз
банка==Твоя бабушка цыганка
банан==Твой папа наркоман
баранка==Твоя мать цыганка
ваза==Поживи пока без газа
воровка==Тебя мама свяжет ловко
гараж==Снимай трусы, иди на пляж
двести==Снимай трусы-иди к невесте
дура==У тебя красивая фигура
дурак==С печи бряк!
зил==Твой папа попой тормозил
карета==Тебе Путин шлёт привета
кирпич==Твоя папа бич
клей==Выпей баночку соплей
кружка==Твоя мать болтушка
кукуруза==Поцелуй цыганке пузо
лук==По лбу стук
чеснок==По спине лопатой НА! 
май==Я пукну, ты поймай
маяк==По башке тебя фигак
муха==Хвать тебя за ухо
оса==Хвать тебя за волоса
птичка==Хвать тебя за яичко
машина==Выпей баночку бензина
ну==Баранки гну, когда согну, дам одну
палка==У тебя на носу галка
пароль==На горшке сидел король
паровоз==Я насрал, а ты повёз
пароход==Снимай трусы иди в поход
печка==Твоя мать узбечка
подвал==Тебя скелет поцеловал
подушка==Твоя мать лягушка
помидор==Твоя бабушка боксёр
рак==Ты дурак
ракета==Ты директор туалета
руль==Я насрал - ты карауль
самолёт==Снимай трусы - иди в полёт
сотка==Твоя мама красотка
три==Сопли подотри
унитаз==Твой папаша водолаз
фонтан==Твои трусы во-о-о-он там
чайник==Твой отец начальник
